%%%%%%%%%%%%%%%%%%%%
%o.....%G G %......%
%..%...%%  %%...%..%
%.%..%........%..%.%
%..%.%.%%%%%%.%.%..%
%........P.........%
%%%%%%%%%%%%%%%%%%%%