%%%%%%%%%%%%%%%
%G.....%......%
%.%%%.....%%%.%
%.....%%%.....%
%.%%..%P%..%%.%
%.............%
%%%%%%%%%%%%%%%